I want the Chrome browser's Places to launch.	( OPEN , component:places , app:chrome )	['<pad>']
I want to access Settings' Traffic Hub.	( OPEN , component:traffic_hub , app:settings )	['<pad>']
Facebook Messenger: Show me the main page	( OPEN , component:main , app:facebook_messenger )	['<pad>']
show me the storage dashboard on dolphin	( OPEN , component:storage_dashboard , app:dolphin )	['<pad>']
press search	( PRESS , search )	['<pad>', 'uninstall', 'update', 'search', 'option', 'rate this app']
On maps, I want to access Location Settings.	( OPEN , component:location_settings , app:google_maps )	['<pad>']
show me Office Lens Conversation	( OPEN , component:conversation , app:office_lens )	['<pad>']
show me settings in opera	( OPEN , component:settings , app:opera )	['<pad>']
I want to access linkedin settings.	( OPEN , component:settings , app:linkedin )	['<pad>']
two-factor authentication with a double tap	( DOUBLE_PRESS , two-factor_authentication )	['<pad>', 'phone numbers', 'change password', "where you're signed in", 'two-factor authentication']
"press ""active logins"" & ""cookies"""	( PRESS , cookies_&_active_logins )	['<pad>', 'open tabs', 'browsing history', 'search history', 'downloads', 'form history', 'cookies & active logins', 'cache', 'offline web data', 'site settings', 'synced tabs', 'cancel', 'clear data']
Double-click “search here”	( DOUBLE_PRESS , search_here )	['<pad>', 'search here', 'account circle', 'latest in the area', 'go', 'saved', 'updates']
show me Share on the Play Store	( OPEN , component:share , app:play_store )	['<pad>']
show me settings in Instagram	( OPEN , component:settings , app:instagram )	['<pad>']
show me the Fitbit location settings.	( OPEN , component:location_settings , app:fitbit )	['<pad>']
show me settings in twitter	( OPEN , component:settings , app:twitter )	['<pad>']
show me Add To Feed on gallery	( OPEN , component:add_to_feed , app:gallery )	['<pad>']
I wish to access the Play Store's System Dashboard.	( OPEN , component:system_dashboard , app:play_store )	['<pad>']
show me the Sound Settings on Twitter	( OPEN , component:sound_settings , app:twitter )	['<pad>']
I want to launch Opera in all-in-one mode.	( OPEN , component:all_in_one , app:opera )	['<pad>']
show me the Dolphin's WiFi Scan Mode.	( OPEN , component:wifi_scan_mode , app:dolphin )	['<pad>']
I want to access the settings for Rich Cards.	( OPEN , component:rich_cards_settings , app:settings )	['<pad>']
show me the system dashboard in Firefox	( OPEN , component:system_dashboard , app:firefox )	['<pad>']
show me the conversation list on the Google Music app.	( OPEN , component:conversation_list , app:google_music_app )	['<pad>']
show me the snooze app on twitter	( OPEN , component:snooze_app , app:twitter )	['<pad>']
show me the Network Dashboard for messages	( OPEN , component:network_dashboard , app:messages )	['<pad>']
show me share on facebook messenger	( OPEN , component:share , app:facebook_messenger )	['<pad>']
show me the Storage Dashboard in the settings	( OPEN , component:storage_dashboard , app:settings )	['<pad>']
Show me a live camera in the gallery.	( OPEN , component:live_camera , app:gallery )	['<pad>']
Choose security and sign-in	( PRESS , sign_in_and_security )	['<pad>', 'account preferences', 'sign in and security', 'visibility', 'communications', 'data privacy', 'advertising data']
the linkedin page	( OPEN , app:linkedin )	['<pad>']
show me the privacy policies on Facebook Messenger.	( OPEN , component:privacy_policy , app:facebook_messenger )	['<pad>']
"select ""new tab"""	( PRESS , new_tab )	['<pad>', 'new tab', 'new private tab', 'bookmarks', 'find in page', 'history', 'settings', 'request desktop data', 'page', 'tools', 'help', 'add-ons']
show me the settings in Chrome	( OPEN , component:settings , app:chrome )	['<pad>']
I wish to access the Places gallery.	( OPEN , component:places , app:gallery )	['<pad>']
show me usage statistics on Fitbit.	( OPEN , component:usage_stats , app:fitbit )	['<pad>']
show me Google Music's storage use	( OPEN , component:storage_use , app:google_music_app )	['<pad>']
teach me the spam settings in Opera	( OPEN , component:spam_settings , app:opera )	['<pad>']
I want to access the settings' Wifi Scan Mode.	( OPEN , component:wifi_scan_mode , app:settings )	['<pad>']
In LinkedIn, show me the Language Settings	( OPEN , component:language_settings , app:linkedin )	['<pad>']
I desire to access the Bookmark Add-on settings.	( OPEN , component:bookmark_add , app:settings )	['<pad>']
I want to access the settings' Show shared locations screen.	( OPEN , component:show_shared_locations_screen , app:settings )	['<pad>']
"select ""uninstall"""	( PRESS , uninstall )	['<pad>', 'uninstall', 'update', 'search', 'option', 'rate this app']
I want to launch Facebook Messenger with All in One.	( OPEN , component:all_in_one , app:facebook_messenger )	['<pad>']
show me Manage Network Usage in the settings	( OPEN , component:manage_network_usage , app:settings )	['<pad>']
select Bluetooth.	( PRESS , bluetooth )	['<pad>', 'bluetooth', 'cast', 'printing', 'files received by bluetooth', 'chromebook', 'nearby share', 'android auto']
Show me the Network Dashboard on Fitbit.	( OPEN , component:network_dashboard , app:fitbit )	['<pad>']
I want to use the Firefox browser to open all in one.	( OPEN , component:all_in_one , app:firefox )	['<pad>']
show me the App discovery gallery	( OPEN , component:app_discovery , app:gallery )	['<pad>']
I can see a mobile network in the office.	( OPEN , component:mobile_network , app:office_lens )	['<pad>']
I want to access mails in Chrome Tabs.	( OPEN , component:chrome_tabbed , app:messages )	['<pad>']
I want to see Add To Story on Facebook Messenger.	( OPEN , component:add_to_story , app:facebook_messenger )	['<pad>']
Show Chrome Tabs for Me in Chrome	( OPEN , component:chrome_tabbed , app:chrome )	['<pad>']
Show me the Start screen on the Google Maps app.	( OPEN , component:start_screen , app:google_maps )	['<pad>']
I want to access the Language menu and make a setting.	( OPEN , component:language_and_input , app:settings )	['<pad>']
I want to access Fitbit's settings.	( OPEN , component:settings , app:fitbit )	['<pad>']
tap to reveal payment options	( PRESS , access_payment_methods )	['<pad>', 'clear browsing data', 'do not track', 'access payment methods', 'google services', 'preload pages for faster browsing and searching']
showing me Stories on Instagram	( OPEN , component:story , app:instagram )	['<pad>']
show me settings on the office lens	( OPEN , component:settings , app:office_lens )	['<pad>']
show me the privacy dashboard on Twitter	( OPEN , component:privacy_dashboard , app:twitter )	['<pad>']
show me the Google Maps language and input options	( OPEN , component:language_and_input , app:google_maps )	['<pad>']
calendar, please	( OPEN , app:calendar )	['<pad>']
show me share in opera	( OPEN , component:share , app:opera )	['<pad>']
I wish to access the gallery's live camera.	( OPEN , component:live_camera , app:gallery )	['<pad>']
show me settings on the Google Music app.	( OPEN , component:settings , app:google_music_app )	['<pad>']
offer me the Add To Story office lens option.	( OPEN , component:add_to_story , app:office_lens )	['<pad>']
select an overview	( PRESS , overview )	['<pad>', 'overview', 'share apps', 'updates available', 'my apps & games', 'update all', 'see details']
show me the WiFi Scan Mode in settings.	( OPEN , component:wifi_scan_mode , app:settings )	['<pad>']
toggle navigational options	( PRESS , navigation_settings )	['<pad>', 'manage your preferences', 'navigation settings', 'shake to send feedback', 'about', 'terms & privacy', 'sign out of google maps', 'language', 'wifi only', 'offline maps settings', 'google location settings', 'personal content']
I wish to access Facebook Messenger's Location Settings.	( OPEN , component:location_settings , app:facebook_messenger )	['<pad>']
on gallery, please display my usage statistics.	( OPEN , component:usage_stats , app:gallery )	['<pad>']
show me how to use a Google Music account	( OPEN , component:choose_account , app:google_music_app )	['<pad>']
double-click "help"	( DOUBLE_PRESS , help )	['<pad>', 'privacy', 'security', 'help', 'about', 'theme', 'account', 'ads', 'notifications', 'follow and invite friends']
I want to access Settings > Storage Use.	( OPEN , component:storage_use , app:settings )	['<pad>']
dual-tap clear private data	( DOUBLE_PRESS , clear_private_data )	['<pad>', 'sign in', 'make firefox your default browser', 'general', 'search', 'privacy', 'accessibility', 'notifications', 'advanced', 'clear private data', 'mozilla firefox']
I wish to access Tasker's System Dashboard.	( OPEN , component:system_dashboard , app:tasker )	['<pad>']
display my gallery	( OPEN , app:gallery )	['<pad>']
Show me the System dashboard on the Google Maps app.	( OPEN , component:system_dashboard , app:google_maps )	['<pad>']
display Incognito for me in settings	( OPEN , component:incognito , app:settings )	['<pad>']
Select "help"	( PRESS , help )	['<pad>', 'privacy', 'security', 'help', 'about', 'theme', 'account', 'ads', 'notifications', 'follow and invite friends']
showing me the Business Hub on Instagram	( OPEN , component:business_hub , app:instagram )	['<pad>']
I want to access Settings > Choose Account.	( OPEN , component:choose_account , app:settings )	['<pad>']
Open the Snooze app in settings, please.	( OPEN , component:snooze_app , app:settings )	['<pad>']
show me the Network Dashboard in the Google Music app.	( OPEN , component:network_dashboard , app:google_music_app )	['<pad>']
How to use: Press twice	( DOUBLE_PRESS , how_to_use )	['<pad>', 'amazon alexa', 'clock faces', 'apps', 'media', 'wallet', 'how to use']
show me the Support Dashboard in the settings	( OPEN , component:support_dashboard , app:settings )	['<pad>']
I want to access Instagram's Story.	( OPEN , component:story , app:instagram )	['<pad>']
show me all in one on Firefox	( OPEN , component:all_in_one , app:firefox )	['<pad>']
Show Me My Device Information in the Gallery	( OPEN , component:my_device_info , app:gallery )	['<pad>']
a Google Map that displays "Add To Story"	( OPEN , component:add_to_story , app:google_maps )	['<pad>']
show me the Business hub setting	( OPEN , component:business_hub , app:settings )	['<pad>']
choose "Airplane"	( PRESS , airplane_mode )	['<pad>', 'vpn', 'mobile networks', 'bluetooth', 'airplane mode', 'mobile data']
show me Share on messages	( OPEN , component:share , app:messages )	['<pad>']
Clap the clock faces	( PRESS , clock_faces )	['<pad>', 'amazon alexa', 'clock faces', 'apps', 'media', 'wallet', 'how to use']
google services click	( PRESS , google_services )	['<pad>', 'clear browsing data', 'do not track', 'access payment methods', 'google services', 'preload pages for faster browsing and searching']
I want to access the Google Music app's settings.	( OPEN , component:settings , app:google_music_app )	['<pad>']
show me the spam options in the settings	( OPEN , component:spam_settings , app:settings )	['<pad>']
show me the system dashboard in Dolphin	( OPEN , component:system_dashboard , app:dolphin )	['<pad>']
Show me the Google Music app's privacy policies.	( OPEN , component:privacy_policy , app:google_music_app )	['<pad>']
Visit Amazon	( PRESS , amazon )	['<pad>', 'ebay', 'opera logo', 'amazon', 'search']
I want to access the settings for spam.	( OPEN , component:spam_settings , app:settings )	['<pad>']
display settings in the Play Store	( OPEN , component:settings , app:play_store )	['<pad>']
write " I'm not sure " down.	( ENTER , ' I'm not sure ' )	['<pad>']
I want to launch Dolphin's Network Dashboard.	( OPEN , component:network_dashboard , app:dolphin )	['<pad>']
new apn tap	( PRESS , new_apn )	['<pad>', 'back', 'restore default settings', 'new apn']
office lens	( OPEN , app:office_lens )	['<pad>']
show me the Location Settings in the settings	( OPEN , component:location_settings , app:settings )	['<pad>']
show me the privacy policy in the settings	( OPEN , component:privacy_policy , app:settings )	['<pad>']
on Chrome, display the Main	( OPEN , component:main , app:chrome )	['<pad>']
show me the settings in the gallery	( OPEN , component:settings , app:gallery )	['<pad>']
click twice to play a test sound	( DOUBLE_PRESS , play_test_sound )	['<pad>', 'voice level', 'voice selection', 'play voice over bluetooth', 'play voice during phone calls', 'play test sound', 'google assistant settings']
in gallery, play me the reel	( OPEN , component:reel , app:gallery )	['<pad>']
I want the Google Maps app to launch Reel.	( OPEN , component:reel , app:google_maps )	['<pad>']
click on adaptive battery	( PRESS , adaptive_battery )	['<pad>', 'battery usage', 'battery saver', 'adaptive battery', 'battery percentage']
I want to access the settings' Usage Stats.	( OPEN , component:usage_stats , app:settings )	['<pad>']
I want a map.	( OPEN , app:google_maps )	['<pad>']
On the settings, I want to enable Mobile Network.	( OPEN , component:mobile_network , app:settings )	['<pad>']
to the right	( SWIPE , RIGHT )	['<pad>']
to the left	( SWIPE , LEFT )	['<pad>']
to the bottom	( SWIPE , DOWN )	['<pad>']
to the top	( SWIPE , UP )	['<pad>']
I desire to launch Reel in settings.	( OPEN , component:reel , app:settings )	['<pad>']
click on browsing history	( PRESS , browsing_history )	['<pad>', 'browsing history', 'cache and site data', 'cookies', 'clear selected data', 'form data', 'passwords', 'location access']
On settings, I want to access the Sound Settings.	( OPEN , component:sound_settings , app:settings )	['<pad>']
Show Me Storage Use in the Settings	( OPEN , component:storage_use , app:settings )	['<pad>']
show me share on twitter	( OPEN , component:share , app:twitter )	['<pad>']
show me the Google Music app's spam settings	( OPEN , component:spam_settings , app:google_music_app )	['<pad>']
Show Me Storage Dashboard in Firefox	( OPEN , component:storage_dashboard , app:firefox )	['<pad>']
show me the Dolphin Language Settings	( OPEN , component:language_settings , app:dolphin )	['<pad>']
Show me the System Dashboard in Opera	( OPEN , component:system_dashboard , app:opera )	['<pad>']
"on Firefox, it displays ""Add To Story"""	( OPEN , component:add_to_story , app:firefox )	['<pad>']
Please enter czxczgsterwaxdqdsa.	( ENTER , ' czxczgsterwaxdqdsa ' )	['<pad>']
show me the network dashboard in Chrome	( OPEN , component:network_dashboard , app:chrome )	['<pad>']
Message on settings, please	( OPEN , component:message , app:settings )	['<pad>']
I wish to see Google Map's Location Settings.	( OPEN , component:location_settings , app:google_maps )	['<pad>']
visit how to use	( PRESS , how_to_use )	['<pad>', 'amazon alexa', 'clock faces', 'apps', 'media', 'wallet', 'how to use']
display Choose Account in Settings for me	( OPEN , component:choose_account , app:settings )	['<pad>']
hit help	( PRESS , help )	['<pad>', 'privacy', 'security', 'help', 'about', 'theme', 'account', 'ads', 'notifications', 'follow and invite friends']
show me the conversations on Instagram	( OPEN , component:conversation_list , app:instagram )	['<pad>']
click on how to use	( PRESS , how_to_use )	['<pad>', 'amazon alexa', 'clock faces', 'apps', 'media', 'wallet', 'how to use']
show me all in one on tasker.	( OPEN , component:all_in_one , app:tasker )	['<pad>']
I wish to access the office lens's settings.	( OPEN , component:settings , app:office_lens )	['<pad>']
Show me the conversations on Messenger	( OPEN , component:conversation_list , app:facebook_messenger )	['<pad>']
show me the Storage Dashboard on Fitbit.	( OPEN , component:storage_dashboard , app:fitbit )	['<pad>']