I want to go to VIEW Videos Bookmarked on world cuisines	( OPEN , component:view_videos_bookmarked , app:world_cuisines )	['<pad>']
I want to show me VIEW Main on fast notepad	( OPEN , component:view_main , app:fast_notepad )	['<pad>']
I want to go to VIEW Introduction on world cuisines	( OPEN , component:view_introduction , app:world_cuisines )	['<pad>']
open VIEW eggtimer Main on steak timer	( OPEN , component:view_eggtimer_main , app:steak_timer )	['<pad>']
in fast notepad launch SEND Edit	( OPEN , component:send_edit , app:fast_notepad )	['<pad>']
launch VIEW Comments on world cuisines	( OPEN , component:view_comments , app:world_cuisines )	['<pad>']
start VIEW Main on unit converter ultimate	( OPEN , component:view_main , app:unit_converter_ultimate )	['<pad>']
start VIEW gms tagmanager Tag Manager Preview on steak timer	( OPEN , component:view_gms_tagmanager_tag_manager_preview , app:steak_timer )	['<pad>']
access VIEW Detail on world cuisines	( OPEN , component:view_detail , app:world_cuisines )	['<pad>']
I want to go to VIEW firebase auth internal Generic Idp on world cuisines	( OPEN , component:view_firebase_auth_internal_generic_idp , app:world_cuisines )	['<pad>']
press text size	( PRESS , text_size )	['<pad>', 'healthy burger', 'my account', 'my recipe', 'cooking', 'settings', 'text size', 'next', 'ok', "let's go", 'start', 'stop', 'yes']
long click let's go	( LONG_PRESS , let's_go )	['<pad>', 'healthy burger', 'my account', 'my recipe', 'cooking', 'settings', 'text size', 'next', 'ok', "let's go", 'start', 'stop', 'yes']
long press healthy burger	( LONG_PRESS , healthy_burger )	['<pad>', 'healthy burger', 'my account', 'my recipe', 'cooking', 'settings', 'text size', 'next', 'ok', "let's go", 'start', 'stop', 'yes']
in world cuisines turn on VIEW Recipe Store	( OPEN , component:view_recipe_store , app:world_cuisines )	['<pad>']
double click my recipe	( DOUBLE_PRESS , my_recipe )	['<pad>', 'healthy burger', 'my account', 'my recipe', 'cooking', 'settings', 'text size', 'next', 'ok', "let's go", 'start', 'stop', 'yes']
choose my account	( PRESS , my_account )	['<pad>', 'healthy burger', 'my account', 'my recipe', 'cooking', 'settings', 'text size', 'next', 'ok', "let's go", 'start', 'stop', 'yes']
go to VIEW My Recipes Grid on world cuisines	( OPEN , component:view_my_recipes_grid , app:world_cuisines )	['<pad>']
select next	( PRESS , next )	['<pad>', 'healthy burger', 'my account', 'my recipe', 'cooking', 'settings', 'text size', 'next', 'ok', "let's go", 'start', 'stop', 'yes']
double tap start	( DOUBLE_PRESS , start )	['<pad>', 'healthy burger', 'my account', 'my recipe', 'cooking', 'settings', 'text size', 'next', 'ok', "let's go", 'start', 'stop', 'yes']
check off let's go	( PRESS , let's_go )	['<pad>', 'healthy burger', 'my account', 'my recipe', 'cooking', 'settings', 'text size', 'next', 'ok', "let's go", 'start', 'stop', 'yes']
turn on VIEW Favorites on world cuisines	( OPEN , component:view_favorites , app:world_cuisines )	['<pad>']
start VIEW Video Preview on world cuisines	( OPEN , component:view_video_preview , app:world_cuisines )	['<pad>']
on world cuisines go to VIEW Splash	( OPEN , component:view_splash , app:world_cuisines )	['<pad>']
on world cuisines go to VIEW Video Grid	( OPEN , component:view_video_grid , app:world_cuisines )	['<pad>']
swipe to the bottom	( SWIPE , DOWN )	['<pad>']
double click settings	( DOUBLE_PRESS , settings )	['<pad>', 'healthy burger', 'my account', 'my recipe', 'cooking', 'settings', 'text size', 'next', 'ok', "let's go", 'start', 'stop', 'yes']
go to SEND Edit on fast notepad	( OPEN , component:send_edit , app:fast_notepad )	['<pad>']
in world cuisines turn on VIEW firebase auth internal Recaptcha	( OPEN , component:view_firebase_auth_internal_recaptcha , app:world_cuisines )	['<pad>']
launch VIEW User Profile on world cuisines	( OPEN , component:view_user_profile , app:world_cuisines )	['<pad>']
turn on VIEW Shoppinglist on world cuisines	( OPEN , component:view_shoppinglist , app:world_cuisines )	['<pad>']
scroll right	( SWIPE , RIGHT )	['<pad>']
open steak timer	( OPEN , app:steak_timer )	['<pad>']
on world cuisines go to VIEW Search	( OPEN , component:view_search , app:world_cuisines )	['<pad>']
long press let's go	( LONG_PRESS , let's_go )	['<pad>', 'healthy burger', 'my account', 'my recipe', 'cooking', 'settings', 'text size', 'next', 'ok', "let's go", 'start', 'stop', 'yes']
on world cuisines open VIEW Home	( OPEN , component:view_home , app:world_cuisines )	['<pad>']
start VIEW Language on world cuisines	( OPEN , component:view_language , app:world_cuisines )	['<pad>']
go to VIEW Video Search on world cuisines	( OPEN , component:view_video_search , app:world_cuisines )	['<pad>']
go to unit converter ultimate	( OPEN , app:unit_converter_ultimate )	['<pad>']
double press ok	( DOUBLE_PRESS , ok )	['<pad>', 'healthy burger', 'my account', 'my recipe', 'cooking', 'settings', 'text size', 'next', 'ok', "let's go", 'start', 'stop', 'yes']
double click yes	( DOUBLE_PRESS , yes )	['<pad>', 'healthy burger', 'my account', 'my recipe', 'cooking', 'settings', 'text size', 'next', 'ok', "let's go", 'start', 'stop', 'yes']
turn on start	( PRESS , start )	['<pad>', 'healthy burger', 'my account', 'my recipe', 'cooking', 'settings', 'text size', 'next', 'ok', "let's go", 'start', 'stop', 'yes']
start VIEW Purchase on world cuisines	( OPEN , component:view_purchase , app:world_cuisines )	['<pad>']
choose cooking	( PRESS , cooking )	['<pad>', 'healthy burger', 'my account', 'my recipe', 'cooking', 'settings', 'text size', 'next', 'ok', "let's go", 'start', 'stop', 'yes']
long tap next	( LONG_PRESS , next )	['<pad>', 'healthy burger', 'my account', 'my recipe', 'cooking', 'settings', 'text size', 'next', 'ok', "let's go", 'start', 'stop', 'yes']
on world cuisines go to VIEW Detail	( OPEN , component:view_detail , app:world_cuisines )	['<pad>']
long click my recipe	( LONG_PRESS , my_recipe )	['<pad>', 'healthy burger', 'my account', 'my recipe', 'cooking', 'settings', 'text size', 'next', 'ok', "let's go", 'start', 'stop', 'yes']
launch VIEW Main on fast notepad	( OPEN , component:view_main , app:fast_notepad )	['<pad>']
choose text size	( PRESS , text_size )	['<pad>', 'healthy burger', 'my account', 'my recipe', 'cooking', 'settings', 'text size', 'next', 'ok', "let's go", 'start', 'stop', 'yes']
click my account	( PRESS , my_account )	['<pad>', 'healthy burger', 'my account', 'my recipe', 'cooking', 'settings', 'text size', 'next', 'ok', "let's go", 'start', 'stop', 'yes']
show me VIEW Shoppinglist on world cuisines	( OPEN , component:view_shoppinglist , app:world_cuisines )	['<pad>']
open VIEW Favorite Detail on world cuisines	( OPEN , component:view_favorite_detail , app:world_cuisines )	['<pad>']
open VIEW Search on world cuisines	( OPEN , component:view_search , app:world_cuisines )	['<pad>']
on world cuisines go to VIEW Settings	( OPEN , component:view_settings , app:world_cuisines )	['<pad>']
on world cuisines turn on VIEW Grid	( OPEN , component:view_grid , app:world_cuisines )	['<pad>']
open VIEW Purchase on world cuisines	( OPEN , component:view_purchase , app:world_cuisines )	['<pad>']
open VIEW Recipe Store on world cuisines	( OPEN , component:view_recipe_store , app:world_cuisines )	['<pad>']
go to fast notepad	( OPEN , app:fast_notepad )	['<pad>']
scroll down to the bottom	( SWIPE , DOWN )	['<pad>']
choose stop	( PRESS , stop )	['<pad>', 'healthy burger', 'my account', 'my recipe', 'cooking', 'settings', 'text size', 'next', 'ok', "let's go", 'start', 'stop', 'yes']
double click next	( DOUBLE_PRESS , next )	['<pad>', 'healthy burger', 'my account', 'my recipe', 'cooking', 'settings', 'text size', 'next', 'ok', "let's go", 'start', 'stop', 'yes']
long click settings	( LONG_PRESS , settings )	['<pad>', 'healthy burger', 'my account', 'my recipe', 'cooking', 'settings', 'text size', 'next', 'ok', "let's go", 'start', 'stop', 'yes']
go to healthy burger	( PRESS , healthy_burger )	['<pad>', 'healthy burger', 'my account', 'my recipe', 'cooking', 'settings', 'text size', 'next', 'ok', "let's go", 'start', 'stop', 'yes']
go to VIEW User Profile on world cuisines	( OPEN , component:view_user_profile , app:world_cuisines )	['<pad>']
open VIEW Grid on world cuisines	( OPEN , component:view_grid , app:world_cuisines )	['<pad>']
long tap my account	( LONG_PRESS , my_account )	['<pad>', 'healthy burger', 'my account', 'my recipe', 'cooking', 'settings', 'text size', 'next', 'ok', "let's go", 'start', 'stop', 'yes']
double tap yes	( DOUBLE_PRESS , yes )	['<pad>', 'healthy burger', 'my account', 'my recipe', 'cooking', 'settings', 'text size', 'next', 'ok', "let's go", 'start', 'stop', 'yes']
I want to go to VIEW Language on world cuisines	( OPEN , component:view_language , app:world_cuisines )	['<pad>']
on world cuisines start VIEW Settings	( OPEN , component:view_settings , app:world_cuisines )	['<pad>']
long press cooking	( LONG_PRESS , cooking )	['<pad>', 'healthy burger', 'my account', 'my recipe', 'cooking', 'settings', 'text size', 'next', 'ok', "let's go", 'start', 'stop', 'yes']
go to yes	( PRESS , yes )	['<pad>', 'healthy burger', 'my account', 'my recipe', 'cooking', 'settings', 'text size', 'next', 'ok', "let's go", 'start', 'stop', 'yes']
double tap cooking	( DOUBLE_PRESS , cooking )	['<pad>', 'healthy burger', 'my account', 'my recipe', 'cooking', 'settings', 'text size', 'next', 'ok', "let's go", 'start', 'stop', 'yes']
press stop	( PRESS , stop )	['<pad>', 'healthy burger', 'my account', 'my recipe', 'cooking', 'settings', 'text size', 'next', 'ok', "let's go", 'start', 'stop', 'yes']
launch world cuisines	( OPEN , app:world_cuisines )	['<pad>']
turn on VIEW Main on fast notepad	( OPEN , component:view_main , app:fast_notepad )	['<pad>']
start fast notepad	( OPEN , app:fast_notepad )	['<pad>']
start VIEW Detail on world cuisines	( OPEN , component:view_detail , app:world_cuisines )	['<pad>']
start VIEW Favorites on world cuisines	( OPEN , component:view_favorites , app:world_cuisines )	['<pad>']
click stop	( PRESS , stop )	['<pad>', 'healthy burger', 'my account', 'my recipe', 'cooking', 'settings', 'text size', 'next', 'ok', "let's go", 'start', 'stop', 'yes']
choose my recipe	( PRESS , my_recipe )	['<pad>', 'healthy burger', 'my account', 'my recipe', 'cooking', 'settings', 'text size', 'next', 'ok', "let's go", 'start', 'stop', 'yes']
go to start	( PRESS , start )	['<pad>', 'healthy burger', 'my account', 'my recipe', 'cooking', 'settings', 'text size', 'next', 'ok', "let's go", 'start', 'stop', 'yes']
I want to open VIEW Settings on world cuisines	( OPEN , component:view_settings , app:world_cuisines )	['<pad>']
tap text size	( PRESS , text_size )	['<pad>', 'healthy burger', 'my account', 'my recipe', 'cooking', 'settings', 'text size', 'next', 'ok', "let's go", 'start', 'stop', 'yes']
check off cooking	( PRESS , cooking )	['<pad>', 'healthy burger', 'my account', 'my recipe', 'cooking', 'settings', 'text size', 'next', 'ok', "let's go", 'start', 'stop', 'yes']
in world cuisines open VIEW Favorites	( OPEN , component:view_favorites , app:world_cuisines )	['<pad>']
I want to launch VIEW Splash on world cuisines	( OPEN , component:view_splash , app:world_cuisines )	['<pad>']
access VIEW Video Preview on world cuisines	( OPEN , component:view_video_preview , app:world_cuisines )	['<pad>']
I want to go to VIEW Comments on world cuisines	( OPEN , component:view_comments , app:world_cuisines )	['<pad>']
go to VIEW Purchase on world cuisines	( OPEN , component:view_purchase , app:world_cuisines )	['<pad>']
launch VIEW Shoppinglist on world cuisines	( OPEN , component:view_shoppinglist , app:world_cuisines )	['<pad>']
start Edit on fast notepad	( OPEN , component:edit , app:fast_notepad )	['<pad>']
long press next	( LONG_PRESS , next )	['<pad>', 'healthy burger', 'my account', 'my recipe', 'cooking', 'settings', 'text size', 'next', 'ok', "let's go", 'start', 'stop', 'yes']
access VIEW Main on fast notepad	( OPEN , component:view_main , app:fast_notepad )	['<pad>']
check off settings	( PRESS , settings )	['<pad>', 'healthy burger', 'my account', 'my recipe', 'cooking', 'settings', 'text size', 'next', 'ok', "let's go", 'start', 'stop', 'yes']
show me VIEW Grid on world cuisines	( OPEN , component:view_grid , app:world_cuisines )	['<pad>']
I want to turn on Edit on fast notepad	( OPEN , component:edit , app:fast_notepad )	['<pad>']
open VIEW Language on world cuisines	( OPEN , component:view_language , app:world_cuisines )	['<pad>']
go to next	( PRESS , next )	['<pad>', 'healthy burger', 'my account', 'my recipe', 'cooking', 'settings', 'text size', 'next', 'ok', "let's go", 'start', 'stop', 'yes']
double click healthy burger	( DOUBLE_PRESS , healthy_burger )	['<pad>', 'healthy burger', 'my account', 'my recipe', 'cooking', 'settings', 'text size', 'next', 'ok', "let's go", 'start', 'stop', 'yes']
I want to go to VIEW Favorites on world cuisines	( OPEN , component:view_favorites , app:world_cuisines )	['<pad>']
launch VIEW Video Grid on world cuisines	( OPEN , component:view_video_grid , app:world_cuisines )	['<pad>']
go to ok	( PRESS , ok )	['<pad>', 'healthy burger', 'my account', 'my recipe', 'cooking', 'settings', 'text size', 'next', 'ok', "let's go", 'start', 'stop', 'yes']
double press settings	( DOUBLE_PRESS , settings )	['<pad>', 'healthy burger', 'my account', 'my recipe', 'cooking', 'settings', 'text size', 'next', 'ok', "let's go", 'start', 'stop', 'yes']
go to VIEW Comments on world cuisines	( OPEN , component:view_comments , app:world_cuisines )	['<pad>']
launch VIEW Videos Bookmarked on world cuisines	( OPEN , component:view_videos_bookmarked , app:world_cuisines )	['<pad>']
show me VIEW Home on world cuisines	( OPEN , component:view_home , app:world_cuisines )	['<pad>']
select yes	( PRESS , yes )	['<pad>', 'healthy burger', 'my account', 'my recipe', 'cooking', 'settings', 'text size', 'next', 'ok', "let's go", 'start', 'stop', 'yes']
start VIEW Main on fast notepad	( OPEN , component:view_main , app:fast_notepad )	['<pad>']
show me VIEW Main on unit converter ultimate	( OPEN , component:view_main , app:unit_converter_ultimate )	['<pad>']
show me VIEW Splash on world cuisines	( OPEN , component:view_splash , app:world_cuisines )	['<pad>']
double tap settings	( DOUBLE_PRESS , settings )	['<pad>', 'healthy burger', 'my account', 'my recipe', 'cooking', 'settings', 'text size', 'next', 'ok', "let's go", 'start', 'stop', 'yes']
tap stop	( PRESS , stop )	['<pad>', 'healthy burger', 'my account', 'my recipe', 'cooking', 'settings', 'text size', 'next', 'ok', "let's go", 'start', 'stop', 'yes']
double tap let's go	( DOUBLE_PRESS , let's_go )	['<pad>', 'healthy burger', 'my account', 'my recipe', 'cooking', 'settings', 'text size', 'next', 'ok', "let's go", 'start', 'stop', 'yes']
choose settings	( PRESS , settings )	['<pad>', 'healthy burger', 'my account', 'my recipe', 'cooking', 'settings', 'text size', 'next', 'ok', "let's go", 'start', 'stop', 'yes']
open VIEW firebase auth internal Generic Idp on world cuisines	( OPEN , component:view_firebase_auth_internal_generic_idp , app:world_cuisines )	['<pad>']
select healthy burger	( PRESS , healthy_burger )	['<pad>', 'healthy burger', 'my account', 'my recipe', 'cooking', 'settings', 'text size', 'next', 'ok', "let's go", 'start', 'stop', 'yes']
double click cooking	( DOUBLE_PRESS , cooking )	['<pad>', 'healthy burger', 'my account', 'my recipe', 'cooking', 'settings', 'text size', 'next', 'ok', "let's go", 'start', 'stop', 'yes']
on world cuisines go to VIEW Videos Bookmarked	( OPEN , component:view_videos_bookmarked , app:world_cuisines )	['<pad>']
go to settings	( PRESS , settings )	['<pad>', 'healthy burger', 'my account', 'my recipe', 'cooking', 'settings', 'text size', 'next', 'ok', "let's go", 'start', 'stop', 'yes']
double tap ok	( DOUBLE_PRESS , ok )	['<pad>', 'healthy burger', 'my account', 'my recipe', 'cooking', 'settings', 'text size', 'next', 'ok', "let's go", 'start', 'stop', 'yes']
turn on my account	( PRESS , my_account )	['<pad>', 'healthy burger', 'my account', 'my recipe', 'cooking', 'settings', 'text size', 'next', 'ok', "let's go", 'start', 'stop', 'yes']
turn on next	( PRESS , next )	['<pad>', 'healthy burger', 'my account', 'my recipe', 'cooking', 'settings', 'text size', 'next', 'ok', "let's go", 'start', 'stop', 'yes']
double press next	( DOUBLE_PRESS , next )	['<pad>', 'healthy burger', 'my account', 'my recipe', 'cooking', 'settings', 'text size', 'next', 'ok', "let's go", 'start', 'stop', 'yes']
launch VIEW Recipe Store on world cuisines	( OPEN , component:view_recipe_store , app:world_cuisines )	['<pad>']
click text size	( PRESS , text_size )	['<pad>', 'healthy burger', 'my account', 'my recipe', 'cooking', 'settings', 'text size', 'next', 'ok', "let's go", 'start', 'stop', 'yes']
show me VIEW Purchase on world cuisines	( OPEN , component:view_purchase , app:world_cuisines )	['<pad>']
launch VIEW Detail on world cuisines	( OPEN , component:view_detail , app:world_cuisines )	['<pad>']
check off stop	( PRESS , stop )	['<pad>', 'healthy burger', 'my account', 'my recipe', 'cooking', 'settings', 'text size', 'next', 'ok', "let's go", 'start', 'stop', 'yes']
I want to open VIEW firebase auth internal Recaptcha on world cuisines	( OPEN , component:view_firebase_auth_internal_recaptcha , app:world_cuisines )	['<pad>']
select let's go	( PRESS , let's_go )	['<pad>', 'healthy burger', 'my account', 'my recipe', 'cooking', 'settings', 'text size', 'next', 'ok', "let's go", 'start', 'stop', 'yes']
check off my account	( PRESS , my_account )	['<pad>', 'healthy burger', 'my account', 'my recipe', 'cooking', 'settings', 'text size', 'next', 'ok', "let's go", 'start', 'stop', 'yes']
show me fast notepad	( OPEN , app:fast_notepad )	['<pad>']
on world cuisines start VIEW Favorite Detail	( OPEN , component:view_favorite_detail , app:world_cuisines )	['<pad>']
go to VIEW gms tagmanager Tag Manager Preview on steak timer	( OPEN , component:view_gms_tagmanager_tag_manager_preview , app:steak_timer )	['<pad>']
double click start	( DOUBLE_PRESS , start )	['<pad>', 'healthy burger', 'my account', 'my recipe', 'cooking', 'settings', 'text size', 'next', 'ok', "let's go", 'start', 'stop', 'yes']
go to world cuisines	( OPEN , app:world_cuisines )	['<pad>']
double click ok	( DOUBLE_PRESS , ok )	['<pad>', 'healthy burger', 'my account', 'my recipe', 'cooking', 'settings', 'text size', 'next', 'ok', "let's go", 'start', 'stop', 'yes']
start VIEW Grid on world cuisines	( OPEN , component:view_grid , app:world_cuisines )	['<pad>']
show me VIEW Recipe Store on world cuisines	( OPEN , component:view_recipe_store , app:world_cuisines )	['<pad>']
check off start	( PRESS , start )	['<pad>', 'healthy burger', 'my account', 'my recipe', 'cooking', 'settings', 'text size', 'next', 'ok', "let's go", 'start', 'stop', 'yes']
go to steak timer	( OPEN , app:steak_timer )	['<pad>']
select ok	( PRESS , ok )	['<pad>', 'healthy burger', 'my account', 'my recipe', 'cooking', 'settings', 'text size', 'next', 'ok', "let's go", 'start', 'stop', 'yes']
in fast notepad access SEND Edit	( OPEN , component:send_edit , app:fast_notepad )	['<pad>']
on world cuisines access VIEW Shoppinglist	( OPEN , component:view_shoppinglist , app:world_cuisines )	['<pad>']
go to cooking	( PRESS , cooking )	['<pad>', 'healthy burger', 'my account', 'my recipe', 'cooking', 'settings', 'text size', 'next', 'ok', "let's go", 'start', 'stop', 'yes']
start VIEW Home on world cuisines	( OPEN , component:view_home , app:world_cuisines )	['<pad>']
double press yes	( DOUBLE_PRESS , yes )	['<pad>', 'healthy burger', 'my account', 'my recipe', 'cooking', 'settings', 'text size', 'next', 'ok', "let's go", 'start', 'stop', 'yes']
launch VIEW Video Search on world cuisines	( OPEN , component:view_video_search , app:world_cuisines )	['<pad>']
press start	( PRESS , start )	['<pad>', 'healthy burger', 'my account', 'my recipe', 'cooking', 'settings', 'text size', 'next', 'ok', "let's go", 'start', 'stop', 'yes']
open world cuisines	( OPEN , app:world_cuisines )	['<pad>']
choose ok	( PRESS , ok )	['<pad>', 'healthy burger', 'my account', 'my recipe', 'cooking', 'settings', 'text size', 'next', 'ok', "let's go", 'start', 'stop', 'yes']
select start	( PRESS , start )	['<pad>', 'healthy burger', 'my account', 'my recipe', 'cooking', 'settings', 'text size', 'next', 'ok', "let's go", 'start', 'stop', 'yes']
turn on VIEW User Profile on world cuisines	( OPEN , component:view_user_profile , app:world_cuisines )	['<pad>']
turn on fast notepad	( OPEN , app:fast_notepad )	['<pad>']
long tap yes	( LONG_PRESS , yes )	['<pad>', 'healthy burger', 'my account', 'my recipe', 'cooking', 'settings', 'text size', 'next', 'ok', "let's go", 'start', 'stop', 'yes']
go to VIEW Introduction on world cuisines	( OPEN , component:view_introduction , app:world_cuisines )	['<pad>']
I want to go to VIEW Search on world cuisines	( OPEN , component:view_search , app:world_cuisines )	['<pad>']
check off next	( PRESS , next )	['<pad>', 'healthy burger', 'my account', 'my recipe', 'cooking', 'settings', 'text size', 'next', 'ok', "let's go", 'start', 'stop', 'yes']
double click let's go	( DOUBLE_PRESS , let's_go )	['<pad>', 'healthy burger', 'my account', 'my recipe', 'cooking', 'settings', 'text size', 'next', 'ok', "let's go", 'start', 'stop', 'yes']
double tap my account	( DOUBLE_PRESS , my_account )	['<pad>', 'healthy burger', 'my account', 'my recipe', 'cooking', 'settings', 'text size', 'next', 'ok', "let's go", 'start', 'stop', 'yes']
check off yes	( PRESS , yes )	['<pad>', 'healthy burger', 'my account', 'my recipe', 'cooking', 'settings', 'text size', 'next', 'ok', "let's go", 'start', 'stop', 'yes']
on world cuisines go to VIEW Favorite Detail	( OPEN , component:view_favorite_detail , app:world_cuisines )	['<pad>']
launch VIEW Favorites on world cuisines	( OPEN , component:view_favorites , app:world_cuisines )	['<pad>']
check off ok	( PRESS , ok )	['<pad>', 'healthy burger', 'my account', 'my recipe', 'cooking', 'settings', 'text size', 'next', 'ok', "let's go", 'start', 'stop', 'yes']
go to VIEW Video Grid on world cuisines	( OPEN , component:view_video_grid , app:world_cuisines )	['<pad>']
go to VIEW eggtimer Main on steak timer	( OPEN , component:view_eggtimer_main , app:steak_timer )	['<pad>']
launch VIEW Home on world cuisines	( OPEN , component:view_home , app:world_cuisines )	['<pad>']
tap healthy burger	( PRESS , healthy_burger )	['<pad>', 'healthy burger', 'my account', 'my recipe', 'cooking', 'settings', 'text size', 'next', 'ok', "let's go", 'start', 'stop', 'yes']
scroll up to the top	( SWIPE , UP )	['<pad>']
open unit converter ultimate	( OPEN , app:unit_converter_ultimate )	['<pad>']
double press cooking	( DOUBLE_PRESS , cooking )	['<pad>', 'healthy burger', 'my account', 'my recipe', 'cooking', 'settings', 'text size', 'next', 'ok', "let's go", 'start', 'stop', 'yes']
swipe right	( SWIPE , RIGHT )	['<pad>']
long tap cooking	( LONG_PRESS , cooking )	['<pad>', 'healthy burger', 'my account', 'my recipe', 'cooking', 'settings', 'text size', 'next', 'ok', "let's go", 'start', 'stop', 'yes']
open VIEW firebase auth internal Recaptcha on world cuisines	( OPEN , component:view_firebase_auth_internal_recaptcha , app:world_cuisines )	['<pad>']
on world cuisines turn on VIEW Language	( OPEN , component:view_language , app:world_cuisines )	['<pad>']
press next	( PRESS , next )	['<pad>', 'healthy burger', 'my account', 'my recipe', 'cooking', 'settings', 'text size', 'next', 'ok', "let's go", 'start', 'stop', 'yes']
access VIEW User Profile on world cuisines	( OPEN , component:view_user_profile , app:world_cuisines )	['<pad>']
I want to open VIEW Favorite Detail on world cuisines	( OPEN , component:view_favorite_detail , app:world_cuisines )	['<pad>']
double press my account	( DOUBLE_PRESS , my_account )	['<pad>', 'healthy burger', 'my account', 'my recipe', 'cooking', 'settings', 'text size', 'next', 'ok', "let's go", 'start', 'stop', 'yes']
choose start	( PRESS , start )	['<pad>', 'healthy burger', 'my account', 'my recipe', 'cooking', 'settings', 'text size', 'next', 'ok', "let's go", 'start', 'stop', 'yes']
turn on VIEW Main on unit converter ultimate	( OPEN , component:view_main , app:unit_converter_ultimate )	['<pad>']
in world cuisines go to VIEW Video Search	( OPEN , component:view_video_search , app:world_cuisines )	['<pad>']
turn on cooking	( PRESS , cooking )	['<pad>', 'healthy burger', 'my account', 'my recipe', 'cooking', 'settings', 'text size', 'next', 'ok', "let's go", 'start', 'stop', 'yes']
on fast notepad open Edit	( OPEN , component:edit , app:fast_notepad )	['<pad>']
choose next	( PRESS , next )	['<pad>', 'healthy burger', 'my account', 'my recipe', 'cooking', 'settings', 'text size', 'next', 'ok', "let's go", 'start', 'stop', 'yes']
on fast notepad go to VIEW Main	( OPEN , component:view_main , app:fast_notepad )	['<pad>']
access VIEW Main on unit converter ultimate	( OPEN , component:view_main , app:unit_converter_ultimate )	['<pad>']
long tap settings	( LONG_PRESS , settings )	['<pad>', 'healthy burger', 'my account', 'my recipe', 'cooking', 'settings', 'text size', 'next', 'ok', "let's go", 'start', 'stop', 'yes']
turn on stop	( PRESS , stop )	['<pad>', 'healthy burger', 'my account', 'my recipe', 'cooking', 'settings', 'text size', 'next', 'ok', "let's go", 'start', 'stop', 'yes']
turn on ok	( PRESS , ok )	['<pad>', 'healthy burger', 'my account', 'my recipe', 'cooking', 'settings', 'text size', 'next', 'ok', "let's go", 'start', 'stop', 'yes']
double press let's go	( DOUBLE_PRESS , let's_go )	['<pad>', 'healthy burger', 'my account', 'my recipe', 'cooking', 'settings', 'text size', 'next', 'ok', "let's go", 'start', 'stop', 'yes']
access VIEW Purchase on world cuisines	( OPEN , component:view_purchase , app:world_cuisines )	['<pad>']
access VIEW Splash on world cuisines	( OPEN , component:view_splash , app:world_cuisines )	['<pad>']
go to stop	( PRESS , stop )	['<pad>', 'healthy burger', 'my account', 'my recipe', 'cooking', 'settings', 'text size', 'next', 'ok', "let's go", 'start', 'stop', 'yes']
launch VIEW Settings on world cuisines	( OPEN , component:view_settings , app:world_cuisines )	['<pad>']
turn on VIEW Purchase on world cuisines	( OPEN , component:view_purchase , app:world_cuisines )	['<pad>']
go to VIEW Video Preview on world cuisines	( OPEN , component:view_video_preview , app:world_cuisines )	['<pad>']
on world cuisines start VIEW Splash	( OPEN , component:view_splash , app:world_cuisines )	['<pad>']
go to let's go	( PRESS , let's_go )	['<pad>', 'healthy burger', 'my account', 'my recipe', 'cooking', 'settings', 'text size', 'next', 'ok', "let's go", 'start', 'stop', 'yes']
on world cuisines access VIEW Language	( OPEN , component:view_language , app:world_cuisines )	['<pad>']
long click my account	( LONG_PRESS , my_account )	['<pad>', 'healthy burger', 'my account', 'my recipe', 'cooking', 'settings', 'text size', 'next', 'ok', "let's go", 'start', 'stop', 'yes']
