I wish to visit the international cuisines section of the bookmarked videos.	( OPEN , component:view_videos_bookmarked , app:world_cuisines )	['<pad>']
I would like to view Main on the notepad.	( OPEN , component:view_main , app:fast_notepad )	['<pad>']
I intend to visit the Introduction on World Cuisines page.	( OPEN , component:view_introduction , app:world_cuisines )	['<pad>']
open steak timer and view eggtimer Main	( OPEN , component:view_eggtimer_main , app:steak_timer )	['<pad>']
quickly launch notepad and SEND Edit	( OPEN , component:send_edit , app:fast_notepad )	['<pad>']
VIEW Comments about international cuisines	( OPEN , component:view_comments , app:world_cuisines )	['<pad>']
begin VIEW Main on the ultimate unit converter	( OPEN , component:view_main , app:unit_converter_ultimate )	['<pad>']
view gms tagmanager tag manager preview on the timer for the steak	( OPEN , component:view_gms_tagmanager_tag_manager_preview , app:steak_timer )	['<pad>']
view more information about international cuisines	( OPEN , component:view_detail , app:world_cuisines )	['<pad>']
On world cuisines, I would like to view firebase auth internal Generic Idp.	( OPEN , component:view_firebase_auth_internal_generic_idp , app:world_cuisines )	['<pad>']
toggle text size	( PRESS , text_size )	['<pad>', 'healthy burger', 'my account', 'my recipe', 'cooking', 'settings', 'text size', 'next', 'ok', "let's go", 'start', 'stop', 'yes']
switch on VIEW Recipe Store for world cuisines.	( OPEN , component:view_recipe_store , app:world_cuisines )	['<pad>']
click twice on my recipe	( DOUBLE_PRESS , my_recipe )	['<pad>', 'healthy burger', 'my account', 'my recipe', 'cooking', 'settings', 'text size', 'next', 'ok', "let's go", 'start', 'stop', 'yes']
select my account	( PRESS , my_account )	['<pad>', 'healthy burger', 'my account', 'my recipe', 'cooking', 'settings', 'text size', 'next', 'ok', "let's go", 'start', 'stop', 'yes']
to view your recipes, visit the global cuisines page.	( OPEN , component:view_my_recipes_grid , app:world_cuisines )	['<pad>']
choose next	( PRESS , next )	['<pad>', 'healthy burger', 'my account', 'my recipe', 'cooking', 'settings', 'text size', 'next', 'ok', "let's go", 'start', 'stop', 'yes']
double-tap to begin	( DOUBLE_PRESS , start )	['<pad>', 'healthy burger', 'my account', 'my recipe', 'cooking', 'settings', 'text size', 'next', 'ok', "let's go", 'start', 'stop', 'yes']
Check, let's move.	( PRESS , let's_go )	['<pad>', 'healthy burger', 'my account', 'my recipe', 'cooking', 'settings', 'text size', 'next', 'ok', "let's go", 'start', 'stop', 'yes']
on VIEW Favorites for international cuisines	( OPEN , component:view_favorites , app:world_cuisines )	['<pad>']
start watching the world cuisines video preview	( OPEN , component:view_video_preview , app:world_cuisines )	['<pad>']
VIEW Splash to learn more about international cuisines	( OPEN , component:view_splash , app:world_cuisines )	['<pad>']
go to VIEW Video Grid on the world cuisines page	( OPEN , component:view_video_grid , app:world_cuisines )	['<pad>']
To the bottom, swipe	( SWIPE , DOWN )	['<pad>']
two clicks of the settings	( DOUBLE_PRESS , settings )	['<pad>', 'healthy burger', 'my account', 'my recipe', 'cooking', 'settings', 'text size', 'next', 'ok', "let's go", 'start', 'stop', 'yes']
choose SEND Edit in the quick notepad.	( OPEN , component:send_edit , app:fast_notepad )	['<pad>']
switch on VIEW firebase auth internal Recaptcha in world cuisines	( OPEN , component:view_firebase_auth_internal_recaptcha , app:world_cuisines )	['<pad>']
START VIEW User Profile on global food	( OPEN , component:view_user_profile , app:world_cuisines )	['<pad>']
switch on VIEW Shoppinglist for world dishes	( OPEN , component:view_shoppinglist , app:world_cuisines )	['<pad>']
to the right	( SWIPE , RIGHT )	['<pad>']
erect a steak timer	( OPEN , app:steak_timer )	['<pad>']
go to VIEW Search on world cuisines	( OPEN , component:view_search , app:world_cuisines )	['<pad>']
open on WORLD cuisine VIEW Home	( OPEN , component:view_home , app:world_cuisines )	['<pad>']
begin VIEW Language on international cuisines	( OPEN , component:view_language , app:world_cuisines )	['<pad>']
VIEW Video Search page for global cuisine	( OPEN , component:view_video_search , app:world_cuisines )	['<pad>']
visit the unit converter website	( OPEN , app:unit_converter_ultimate )	['<pad>']
double-click "ok"	( DOUBLE_PRESS , ok )	['<pad>', 'healthy burger', 'my account', 'my recipe', 'cooking', 'settings', 'text size', 'next', 'ok', "let's go", 'start', 'stop', 'yes']
two yes clicks	( DOUBLE_PRESS , yes )	['<pad>', 'healthy burger', 'my account', 'my recipe', 'cooking', 'settings', 'text size', 'next', 'ok', "let's go", 'start', 'stop', 'yes']
start	( PRESS , start )	['<pad>', 'healthy burger', 'my account', 'my recipe', 'cooking', 'settings', 'text size', 'next', 'ok', "let's go", 'start', 'stop', 'yes']
begin VIEWING Purchases of international foods	( OPEN , component:view_purchase , app:world_cuisines )	['<pad>']
choose VIEW Detail under "World Cuisines"	( OPEN , component:view_detail , app:world_cuisines )	['<pad>']
Long click my recipe	( LONG_PRESS , my_recipe )	['<pad>', 'healthy burger', 'my account', 'my recipe', 'cooking', 'settings', 'text size', 'next', 'ok', "let's go", 'start', 'stop', 'yes']
open VIEW Main on a quick notepad.	( OPEN , component:view_main , app:fast_notepad )	['<pad>']
selecting text size	( PRESS , text_size )	['<pad>', 'healthy burger', 'my account', 'my recipe', 'cooking', 'settings', 'text size', 'next', 'ok', "let's go", 'start', 'stop', 'yes']
Go to My Account.	( PRESS , my_account )	['<pad>', 'healthy burger', 'my account', 'my recipe', 'cooking', 'settings', 'text size', 'next', 'ok', "let's go", 'start', 'stop', 'yes']
view Shoppinglist for world cuisines	( OPEN , component:view_shoppinglist , app:world_cuisines )	['<pad>']
view favourite details on international cuisines	( OPEN , component:view_favorite_detail , app:world_cuisines )	['<pad>']
open VIEW World cuisines search	( OPEN , component:view_search , app:world_cuisines )	['<pad>']
Go to VIEW Settings under "World Cuisines."	( OPEN , component:view_settings , app:world_cuisines )	['<pad>']
switch on VIEW Grid for "world cuisines"	( OPEN , component:view_grid , app:world_cuisines )	['<pad>']
open VIEW Purchase on international cuisines	( OPEN , component:view_purchase , app:world_cuisines )	['<pad>']
open VIEW Recipe Store for world foods	( OPEN , component:view_recipe_store , app:world_cuisines )	['<pad>']
to notepad	( OPEN , app:fast_notepad )	['<pad>']
descending to the bottom	( SWIPE , DOWN )	['<pad>']
Select Stop	( PRESS , stop )	['<pad>', 'healthy burger', 'my account', 'my recipe', 'cooking', 'settings', 'text size', 'next', 'ok', "let's go", 'start', 'stop', 'yes']
Next, click twice	( DOUBLE_PRESS , next )	['<pad>', 'healthy burger', 'my account', 'my recipe', 'cooking', 'settings', 'text size', 'next', 'ok', "let's go", 'start', 'stop', 'yes']
long-press settings	( LONG_PRESS , settings )	['<pad>', 'healthy burger', 'my account', 'my recipe', 'cooking', 'settings', 'text size', 'next', 'ok', "let's go", 'start', 'stop', 'yes']
go to a healthy burger	( PRESS , healthy_burger )	['<pad>', 'healthy burger', 'my account', 'my recipe', 'cooking', 'settings', 'text size', 'next', 'ok', "let's go", 'start', 'stop', 'yes']
on world cuisines, click VIEW User Profile.	( OPEN , component:view_user_profile , app:world_cuisines )	['<pad>']
view the world cuisines grid	( OPEN , component:view_grid , app:world_cuisines )	['<pad>']
Long touch my account	( LONG_PRESS , my_account )	['<pad>', 'healthy burger', 'my account', 'my recipe', 'cooking', 'settings', 'text size', 'next', 'ok', "let's go", 'start', 'stop', 'yes']
double tap “YES”	( DOUBLE_PRESS , yes )	['<pad>', 'healthy burger', 'my account', 'my recipe', 'cooking', 'settings', 'text size', 'next', 'ok', "let's go", 'start', 'stop', 'yes']
View Language on world Cuisines.	( OPEN , component:view_language , app:world_cuisines )	['<pad>']
begin with "world cuisines" VIEW Settings	( OPEN , component:view_settings , app:world_cuisines )	['<pad>']
visit yes	( PRESS , yes )	['<pad>', 'healthy burger', 'my account', 'my recipe', 'cooking', 'settings', 'text size', 'next', 'ok', "let's go", 'start', 'stop', 'yes']
two-tap cooking	( DOUBLE_PRESS , cooking )	['<pad>', 'healthy burger', 'my account', 'my recipe', 'cooking', 'settings', 'text size', 'next', 'ok', "let's go", 'start', 'stop', 'yes']
click Stop	( PRESS , stop )	['<pad>', 'healthy burger', 'my account', 'my recipe', 'cooking', 'settings', 'text size', 'next', 'ok', "let's go", 'start', 'stop', 'yes']
introduce global cuisines	( OPEN , app:world_cuisines )	['<pad>']
enable VIEW Main on the quick notepad.	( OPEN , component:view_main , app:fast_notepad )	['<pad>']
begin quickly notepad	( OPEN , app:fast_notepad )	['<pad>']
view more information about world cuisines	( OPEN , component:view_detail , app:world_cuisines )	['<pad>']
VIEW FAVORITE CUISINES FROM AROUND THE WORLD	( OPEN , component:view_favorites , app:world_cuisines )	['<pad>']
select Stop	( PRESS , stop )	['<pad>', 'healthy burger', 'my account', 'my recipe', 'cooking', 'settings', 'text size', 'next', 'ok', "let's go", 'start', 'stop', 'yes']
pick my recipe	( PRESS , my_recipe )	['<pad>', 'healthy burger', 'my account', 'my recipe', 'cooking', 'settings', 'text size', 'next', 'ok', "let's go", 'start', 'stop', 'yes']
get going	( PRESS , start )	['<pad>', 'healthy burger', 'my account', 'my recipe', 'cooking', 'settings', 'text size', 'next', 'ok', "let's go", 'start', 'stop', 'yes']
I want to access the settings of world cuisines.	( OPEN , component:view_settings , app:world_cuisines )	['<pad>']
adjust text size	( PRESS , text_size )	['<pad>', 'healthy burger', 'my account', 'my recipe', 'cooking', 'settings', 'text size', 'next', 'ok', "let's go", 'start', 'stop', 'yes']
mark the cooking box.	( PRESS , cooking )	['<pad>', 'healthy burger', 'my account', 'my recipe', 'cooking', 'settings', 'text size', 'next', 'ok', "let's go", 'start', 'stop', 'yes']
open WORLD COOKING VIEW FAVORITES	( OPEN , component:view_favorites , app:world_cuisines )	['<pad>']
I want to debut VIEW Splash on international cuisines.	( OPEN , component:view_splash , app:world_cuisines )	['<pad>']
access the world cuisines video preview	( OPEN , component:view_video_preview , app:world_cuisines )	['<pad>']
view comments about world cuisines, please	( OPEN , component:view_comments , app:world_cuisines )	['<pad>']
visit VIEW Purchase on world foods	( OPEN , component:view_purchase , app:world_cuisines )	['<pad>']
launch VIEW Shoppinglist for world foods	( OPEN , component:view_shoppinglist , app:world_cuisines )	['<pad>']
begin editing on a quick notepad	( OPEN , component:edit , app:fast_notepad )	['<pad>']
use VIEW Main on a fast notepad.	( OPEN , component:view_main , app:fast_notepad )	['<pad>']
tick off the settings	( PRESS , settings )	['<pad>', 'healthy burger', 'my account', 'my recipe', 'cooking', 'settings', 'text size', 'next', 'ok', "let's go", 'start', 'stop', 'yes']
VIEW Grid on global cuisines, please	( OPEN , component:view_grid , app:world_cuisines )	['<pad>']
I desire to activate Edit in quick notepad.	( OPEN , component:edit , app:fast_notepad )	['<pad>']
open VIEW Language for world cuisines	( OPEN , component:view_language , app:world_cuisines )	['<pad>']
move on to	( PRESS , next )	['<pad>', 'healthy burger', 'my account', 'my recipe', 'cooking', 'settings', 'text size', 'next', 'ok', "let's go", 'start', 'stop', 'yes']
Double-click the burger	( DOUBLE_PRESS , healthy_burger )	['<pad>', 'healthy burger', 'my account', 'my recipe', 'cooking', 'settings', 'text size', 'next', 'ok', "let's go", 'start', 'stop', 'yes']
I'd like to visit VIEW Favorites on world cuisines.	( OPEN , component:view_favorites , app:world_cuisines )	['<pad>']
introduce the VIEW Video Grid for global cuisines	( OPEN , component:view_video_grid , app:world_cuisines )	['<pad>']
visit ok	( PRESS , ok )	['<pad>', 'healthy burger', 'my account', 'my recipe', 'cooking', 'settings', 'text size', 'next', 'ok', "let's go", 'start', 'stop', 'yes']
settings, pressing twice	( DOUBLE_PRESS , settings )	['<pad>', 'healthy burger', 'my account', 'my recipe', 'cooking', 'settings', 'text size', 'next', 'ok', "let's go", 'start', 'stop', 'yes']
visit the VIEW Comments on cuisines page	( OPEN , component:view_comments , app:world_cuisines )	['<pad>']
launch VIEW Bookmarked Videos on global cuisines	( OPEN , component:view_videos_bookmarked , app:world_cuisines )	['<pad>']
show me VIEW Home on cuisines	( OPEN , component:view_home , app:world_cuisines )	['<pad>']
choose "yes"	( PRESS , yes )	['<pad>', 'healthy burger', 'my account', 'my recipe', 'cooking', 'settings', 'text size', 'next', 'ok', "let's go", 'start', 'stop', 'yes']
begin VIEW Main on a quick notepad.	( OPEN , component:view_main , app:fast_notepad )	['<pad>']
show me VIEW Main on the unit converter.	( OPEN , component:view_main , app:unit_converter_ultimate )	['<pad>']
view Splash on world cuisines for me	( OPEN , component:view_splash , app:world_cuisines )	['<pad>']
double-tap settings	( DOUBLE_PRESS , settings )	['<pad>', 'healthy burger', 'my account', 'my recipe', 'cooking', 'settings', 'text size', 'next', 'ok', "let's go", 'start', 'stop', 'yes']
hit Stop	( PRESS , stop )	['<pad>', 'healthy burger', 'my account', 'my recipe', 'cooking', 'settings', 'text size', 'next', 'ok', "let's go", 'start', 'stop', 'yes']
Double-tap "Go!"	( DOUBLE_PRESS , let's_go )	['<pad>', 'healthy burger', 'my account', 'my recipe', 'cooking', 'settings', 'text size', 'next', 'ok', "let's go", 'start', 'stop', 'yes']
browse settings	( PRESS , settings )	['<pad>', 'healthy burger', 'my account', 'my recipe', 'cooking', 'settings', 'text size', 'next', 'ok', "let's go", 'start', 'stop', 'yes']
open VIEW world cuisines internal Generic Firebase Idp	( OPEN , component:view_firebase_auth_internal_generic_idp , app:world_cuisines )	['<pad>']
pick healthy burgers	( PRESS , healthy_burger )	['<pad>', 'healthy burger', 'my account', 'my recipe', 'cooking', 'settings', 'text size', 'next', 'ok', "let's go", 'start', 'stop', 'yes']
Double-clicking cooking	( DOUBLE_PRESS , cooking )	['<pad>', 'healthy burger', 'my account', 'my recipe', 'cooking', 'settings', 'text size', 'next', 'ok', "let's go", 'start', 'stop', 'yes']
go to VIEW Videos Bookmarked on world cuisines	( OPEN , component:view_videos_bookmarked , app:world_cuisines )	['<pad>']
access settings	( PRESS , settings )	['<pad>', 'healthy burger', 'my account', 'my recipe', 'cooking', 'settings', 'text size', 'next', 'ok', "let's go", 'start', 'stop', 'yes']
Okay, double-tap	( DOUBLE_PRESS , ok )	['<pad>', 'healthy burger', 'my account', 'my recipe', 'cooking', 'settings', 'text size', 'next', 'ok', "let's go", 'start', 'stop', 'yes']
activate my account	( PRESS , my_account )	['<pad>', 'healthy burger', 'my account', 'my recipe', 'cooking', 'settings', 'text size', 'next', 'ok', "let's go", 'start', 'stop', 'yes']
next	( PRESS , next )	['<pad>', 'healthy burger', 'my account', 'my recipe', 'cooking', 'settings', 'text size', 'next', 'ok', "let's go", 'start', 'stop', 'yes']
next, press twice	( DOUBLE_PRESS , next )	['<pad>', 'healthy burger', 'my account', 'my recipe', 'cooking', 'settings', 'text size', 'next', 'ok', "let's go", 'start', 'stop', 'yes']
OPEN VIEW Recipe Store for world dishes	( OPEN , component:view_recipe_store , app:world_cuisines )	['<pad>']
text size, please	( PRESS , text_size )	['<pad>', 'healthy burger', 'my account', 'my recipe', 'cooking', 'settings', 'text size', 'next', 'ok', "let's go", 'start', 'stop', 'yes']
view Purchase on cuisines	( OPEN , component:view_purchase , app:world_cuisines )	['<pad>']
view information about World Cuisines	( OPEN , component:view_detail , app:world_cuisines )	['<pad>']
Select "Stop"	( PRESS , stop )	['<pad>', 'healthy burger', 'my account', 'my recipe', 'cooking', 'settings', 'text size', 'next', 'ok', "let's go", 'start', 'stop', 'yes']
I want to access the world cuisines firebase internal Recaptcha page.	( OPEN , component:view_firebase_auth_internal_recaptcha , app:world_cuisines )	['<pad>']
choose Let's go.	( PRESS , let's_go )	['<pad>', 'healthy burger', 'my account', 'my recipe', 'cooking', 'settings', 'text size', 'next', 'ok', "let's go", 'start', 'stop', 'yes']
tick off my account.	( PRESS , my_account )	['<pad>', 'healthy burger', 'my account', 'my recipe', 'cooking', 'settings', 'text size', 'next', 'ok', "let's go", 'start', 'stop', 'yes']
fast notebook, please	( OPEN , app:fast_notepad )	['<pad>']
starting with world cuisines, VIEW FAVORITE DETAIL	( OPEN , component:view_favorite_detail , app:world_cuisines )	['<pad>']
visit the steak timer's VIEW gms tagmanager Tag Manager Preview page.	( OPEN , component:view_gms_tagmanager_tag_manager_preview , app:steak_timer )	['<pad>']
To start, click twice.	( DOUBLE_PRESS , start )	['<pad>', 'healthy burger', 'my account', 'my recipe', 'cooking', 'settings', 'text size', 'next', 'ok', "let's go", 'start', 'stop', 'yes']
visit world cuisines	( OPEN , app:world_cuisines )	['<pad>']
twice click "ok"	( DOUBLE_PRESS , ok )	['<pad>', 'healthy burger', 'my account', 'my recipe', 'cooking', 'settings', 'text size', 'next', 'ok', "let's go", 'start', 'stop', 'yes']
launch the VIEW Grid for cuisines	( OPEN , component:view_grid , app:world_cuisines )	['<pad>']
show me VIEW Recipe Store for cuisines 	( OPEN , component:view_recipe_store , app:world_cuisines )	['<pad>']
cross off "start"	( PRESS , start )	['<pad>', 'healthy burger', 'my account', 'my recipe', 'cooking', 'settings', 'text size', 'next', 'ok', "let's go", 'start', 'stop', 'yes']
visit steaktimer	( OPEN , app:steak_timer )	['<pad>']
choose ok	( PRESS , ok )	['<pad>', 'healthy burger', 'my account', 'my recipe', 'cooking', 'settings', 'text size', 'next', 'ok', "let's go", 'start', 'stop', 'yes']
quickly access notepad SEND Edit	( OPEN , component:send_edit , app:fast_notepad )	['<pad>']
access to world cuisines’ VIEW Shoppinglist	( OPEN , component:view_shoppinglist , app:world_cuisines )	['<pad>']
to the cooking	( PRESS , cooking )	['<pad>', 'healthy burger', 'my account', 'my recipe', 'cooking', 'settings', 'text size', 'next', 'ok', "let's go", 'start', 'stop', 'yes']
begin VIEW HOME on international cuisines	( OPEN , component:view_home , app:world_cuisines )	['<pad>']
double-click "yes"	( DOUBLE_PRESS , yes )	['<pad>', 'healthy burger', 'my account', 'my recipe', 'cooking', 'settings', 'text size', 'next', 'ok', "let's go", 'start', 'stop', 'yes']
VIEW Video Search for world cuisines	( OPEN , component:view_video_search , app:world_cuisines )	['<pad>']
click "start"	( PRESS , start )	['<pad>', 'healthy burger', 'my account', 'my recipe', 'cooking', 'settings', 'text size', 'next', 'ok', "let's go", 'start', 'stop', 'yes']
world cuisines	( OPEN , app:world_cuisines )	['<pad>']
select "ok"	( PRESS , ok )	['<pad>', 'healthy burger', 'my account', 'my recipe', 'cooking', 'settings', 'text size', 'next', 'ok', "let's go", 'start', 'stop', 'yes']
choose "start"	( PRESS , start )	['<pad>', 'healthy burger', 'my account', 'my recipe', 'cooking', 'settings', 'text size', 'next', 'ok', "let's go", 'start', 'stop', 'yes']
enable VIEW User Profile for WORLD Cuisines	( OPEN , component:view_user_profile , app:world_cuisines )	['<pad>']
quickly start a notepad	( OPEN , app:fast_notepad )	['<pad>']
click here for an overview of world cuisines	( OPEN , component:view_introduction , app:world_cuisines )	['<pad>']
I want to access VIEW Search for international cuisines.	( OPEN , component:view_search , app:world_cuisines )	['<pad>']
then tick next	( PRESS , next )	['<pad>', 'healthy burger', 'my account', 'my recipe', 'cooking', 'settings', 'text size', 'next', 'ok', "let's go", 'start', 'stop', 'yes']
Double-click "Go!"	( DOUBLE_PRESS , let's_go )	['<pad>', 'healthy burger', 'my account', 'my recipe', 'cooking', 'settings', 'text size', 'next', 'ok', "let's go", 'start', 'stop', 'yes']
Tap my account twice	( DOUBLE_PRESS , my_account )	['<pad>', 'healthy burger', 'my account', 'my recipe', 'cooking', 'settings', 'text size', 'next', 'ok', "let's go", 'start', 'stop', 'yes']
tick off "yes"	( PRESS , yes )	['<pad>', 'healthy burger', 'my account', 'my recipe', 'cooking', 'settings', 'text size', 'next', 'ok', "let's go", 'start', 'stop', 'yes']
by selecting VIEW Favorite Detail under international cuisines	( OPEN , component:view_favorite_detail , app:world_cuisines )	['<pad>']
VIEW Favorites on world cuisines	( OPEN , component:view_favorites , app:world_cuisines )	['<pad>']
tick off "ok"	( PRESS , ok )	['<pad>', 'healthy burger', 'my account', 'my recipe', 'cooking', 'settings', 'text size', 'next', 'ok', "let's go", 'start', 'stop', 'yes']
visit the VIEW Video Grid page for world cuisines	( OPEN , component:view_video_grid , app:world_cuisines )	['<pad>']
view the steak timer's eggtimer main page.	( OPEN , component:view_eggtimer_main , app:steak_timer )	['<pad>']
healthy burger	( PRESS , healthy_burger )	['<pad>', 'healthy burger', 'my account', 'my recipe', 'cooking', 'settings', 'text size', 'next', 'ok', "let's go", 'start', 'stop', 'yes']
to the top, scroll	( SWIPE , UP )	['<pad>']
to the right	( SWIPE , RIGHT )	['<pad>']
extended tap cooking	( LONG_PRESS , cooking )	['<pad>', 'healthy burger', 'my account', 'my recipe', 'cooking', 'settings', 'text size', 'next', 'ok', "let's go", 'start', 'stop', 'yes']
toggle on VIEW Language for world cuisines	( OPEN , component:view_language , app:world_cuisines )	['<pad>']
select next.	( PRESS , next )	['<pad>', 'healthy burger', 'my account', 'my recipe', 'cooking', 'settings', 'text size', 'next', 'ok', "let's go", 'start', 'stop', 'yes']
VIEW User Profile on world cuisines	( OPEN , component:view_user_profile , app:world_cuisines )	['<pad>']
I wish to access my favourite information about global cuisines.	( OPEN , component:view_favorite_detail , app:world_cuisines )	['<pad>']
Press "my account" twice	( DOUBLE_PRESS , my_account )	['<pad>', 'healthy burger', 'my account', 'my recipe', 'cooking', 'settings', 'text size', 'next', 'ok', "let's go", 'start', 'stop', 'yes']
select "start"	( PRESS , start )	['<pad>', 'healthy burger', 'my account', 'my recipe', 'cooking', 'settings', 'text size', 'next', 'ok', "let's go", 'start', 'stop', 'yes']
turn on VIEW Main on the ultimate unit converter	( OPEN , component:view_main , app:unit_converter_ultimate )	['<pad>']
visit VIEW Video Search under world cuisines.	( OPEN , component:view_video_search , app:world_cuisines )	['<pad>']
switch on the cooking	( PRESS , cooking )	['<pad>', 'healthy burger', 'my account', 'my recipe', 'cooking', 'settings', 'text size', 'next', 'ok', "let's go", 'start', 'stop', 'yes']
open Edit on quick notepad	( OPEN , component:edit , app:fast_notepad )	['<pad>']
Next selection	( PRESS , next )	['<pad>', 'healthy burger', 'my account', 'my recipe', 'cooking', 'settings', 'text size', 'next', 'ok', "let's go", 'start', 'stop', 'yes']
Go to VIEW Main in quick notebook.	( OPEN , component:view_main , app:fast_notepad )	['<pad>']
access VIEW Main on the unit converter ultimate	( OPEN , component:view_main , app:unit_converter_ultimate )	['<pad>']
long-tap setting	( LONG_PRESS , settings )	['<pad>', 'healthy burger', 'my account', 'my recipe', 'cooking', 'settings', 'text size', 'next', 'ok', "let's go", 'start', 'stop', 'yes']
switch to Stop	( PRESS , stop )	['<pad>', 'healthy burger', 'my account', 'my recipe', 'cooking', 'settings', 'text size', 'next', 'ok', "let's go", 'start', 'stop', 'yes']
switch on ok	( PRESS , ok )	['<pad>', 'healthy burger', 'my account', 'my recipe', 'cooking', 'settings', 'text size', 'next', 'ok', "let's go", 'start', 'stop', 'yes']
Press Let's go twice.	( DOUBLE_PRESS , let's_go )	['<pad>', 'healthy burger', 'my account', 'my recipe', 'cooking', 'settings', 'text size', 'next', 'ok', "let's go", 'start', 'stop', 'yes']
see Splash on international cuisines	( OPEN , component:view_splash , app:world_cuisines )	['<pad>']
visit Stop	( PRESS , stop )	['<pad>', 'healthy burger', 'my account', 'my recipe', 'cooking', 'settings', 'text size', 'next', 'ok', "let's go", 'start', 'stop', 'yes']
VIEW Settings for global cuisines	( OPEN , component:view_settings , app:world_cuisines )	['<pad>']
toggle on VIEW Purchase for world cuisines	( OPEN , component:view_purchase , app:world_cuisines )	['<pad>']
visit VIEW Video Preview on world cuisines	( OPEN , component:view_video_preview , app:world_cuisines )	['<pad>']
begin with "global cuisines" VIEW Splash	( OPEN , component:view_splash , app:world_cuisines )	['<pad>']
visit Let's Go	( PRESS , let's_go )	['<pad>', 'healthy burger', 'my account', 'my recipe', 'cooking', 'settings', 'text size', 'next', 'ok', "let's go", 'start', 'stop', 'yes']
access to WORLD Cuisines VIEW Language	( OPEN , component:view_language , app:world_cuisines )	['<pad>']
long-press "my account"	( LONG_PRESS , my_account )	['<pad>', 'healthy burger', 'my account', 'my recipe', 'cooking', 'settings', 'text size', 'next', 'ok', "let's go", 'start', 'stop', 'yes']
to the right	( SWIPE , RIGHT )	['<pad>']
to the left	( SWIPE , LEFT )	['<pad>']
to the bottom	( SWIPE , DOWN )	['<pad>']
to the top	( SWIPE , UP )	['<pad>']
up	( SWIPE , UP )	['<pad>']
up to the top	( SWIPE , UP )	['<pad>']
to top	( SWIPE , UP )	['<pad>']
down	( SWIPE , DOWN )	['<pad>']
to bottom	( SWIPE , DOWN )	['<pad>']
down to the bottom	( SWIPE , DOWN )	['<pad>']
down and to the bottom	( SWIPE , DOWN )	['<pad>']
up	( SWIPE , UP )	['<pad>']
coming up	( SWIPE , UP )	['<pad>']
going up to the top	( SWIPE , UP )	['<pad>']
page down	( SWIPE , DOWN )	['<pad>']
down over to the bottom	( SWIPE , DOWN )	['<pad>']
left	( SWIPE , LEFT )	['<pad>']
to left	( SWIPE , LEFT )	['<pad>']
right	( SWIPE , RIGHT )	['<pad>']
to right	( SWIPE , RIGHT )	['<pad>']
