I wish to visit the international cuisines section of the bookmarked videos.	( OPEN , component:view_videos_bookmarked , app:world_cuisines )
I would like to view Main on the notepad.	( OPEN , component:view_main , app:fast_notepad )
I intend to visit the Introduction on World Cuisines page.	( OPEN , component:view_introduction , app:world_cuisines )
open steak timer and view eggtimer Main	( OPEN , component:view_eggtimer_main , app:steak_timer )
quickly launch notepad and SEND Edit	( OPEN , component:send_edit , app:fast_notepad )
VIEW Comments about international cuisines	( OPEN , component:view_comments , app:world_cuisines )
begin VIEW Main on the ultimate unit converter	( OPEN , component:view_main , app:unit_converter_ultimate )
view gms tagmanager tag manager preview on the timer for the steak	( OPEN , component:view_gms_tagmanager_tag_manager_preview , app:steak_timer )
view more information about international cuisines	( OPEN , component:view_detail , app:world_cuisines )
On world cuisines, I would like to view firebase auth internal Generic Idp.	( OPEN , component:view_firebase_auth_internal_generic_idp , app:world_cuisines )
toggle text size	( PRESS , text_size )
switch on VIEW Recipe Store for world cuisines.	( OPEN , component:view_recipe_store , app:world_cuisines )
click twice on my recipe	( DOUBLE_PRESS , my_recipe )
select my account	( PRESS , my_account )
to view your recipes, visit the global cuisines page.	( OPEN , component:view_my_recipes_grid , app:world_cuisines )
choose next	( PRESS , next )
double-tap to begin	( DOUBLE_PRESS , start )
Check, let's move.	( PRESS , let's_go )
on VIEW Favorites for international cuisines	( OPEN , component:view_favorites , app:world_cuisines )
start watching the world cuisines video preview	( OPEN , component:view_video_preview , app:world_cuisines )
VIEW Splash to learn more about international cuisines	( OPEN , component:view_splash , app:world_cuisines )
go to VIEW Video Grid on the world cuisines page	( OPEN , component:view_video_grid , app:world_cuisines )
To the bottom, swipe	( SWIPE , DOWN )
two clicks of the settings	( DOUBLE_PRESS , settings )
choose SEND Edit in the quick notepad.	( OPEN , component:send_edit , app:fast_notepad )
switch on VIEW firebase auth internal Recaptcha in world cuisines	( OPEN , component:view_firebase_auth_internal_recaptcha , app:world_cuisines )
START VIEW User Profile on global food	( OPEN , component:view_user_profile , app:world_cuisines )
switch on VIEW Shoppinglist for world dishes	( OPEN , component:view_shoppinglist , app:world_cuisines )
to the right	( SWIPE , RIGHT )
erect a steak timer	( OPEN , app:steak_timer )
go to VIEW Search on world cuisines	( OPEN , component:view_search , app:world_cuisines )
open on WORLD cuisine VIEW Home	( OPEN , component:view_home , app:world_cuisines )
begin VIEW Language on international cuisines	( OPEN , component:view_language , app:world_cuisines )
VIEW Video Search page for global cuisine	( OPEN , component:view_video_search , app:world_cuisines )
visit the unit converter website	( OPEN , app:unit_converter_ultimate )
double-click "ok"	( DOUBLE_PRESS , ok )
two yes clicks	( DOUBLE_PRESS , yes )
start	( PRESS , start )
begin VIEWING Purchases of international foods	( OPEN , component:view_purchase , app:world_cuisines )
choose VIEW Detail under "World Cuisines"	( OPEN , component:view_detail , app:world_cuisines )
Long click my recipe	( LONG_PRESS , my_recipe )
open VIEW Main on a quick notepad.	( OPEN , component:view_main , app:fast_notepad )
selecting text size	( PRESS , text_size )
Go to My Account.	( PRESS , my_account )
view Shoppinglist for world cuisines	( OPEN , component:view_shoppinglist , app:world_cuisines )
view favourite details on international cuisines	( OPEN , component:view_favorite_detail , app:world_cuisines )
open VIEW World cuisines search	( OPEN , component:view_search , app:world_cuisines )
Go to VIEW Settings under "World Cuisines."	( OPEN , component:view_settings , app:world_cuisines )
switch on VIEW Grid for "world cuisines"	( OPEN , component:view_grid , app:world_cuisines )
open VIEW Purchase on international cuisines	( OPEN , component:view_purchase , app:world_cuisines )
open VIEW Recipe Store for world foods	( OPEN , component:view_recipe_store , app:world_cuisines )
to notepad	( OPEN , app:fast_notepad )
descending to the bottom	( SWIPE , DOWN )
Select Stop	( PRESS , stop )
Next, click twice	( DOUBLE_PRESS , next )
long-press settings	( LONG_PRESS , settings )
go to a healthy burger	( PRESS , healthy_burger )
on world cuisines, click VIEW User Profile.	( OPEN , component:view_user_profile , app:world_cuisines )
view the world cuisines grid	( OPEN , component:view_grid , app:world_cuisines )
Long touch my account	( LONG_PRESS , my_account )
double tap “YES”	( DOUBLE_PRESS , yes )
View Language on world Cuisines.	( OPEN , component:view_language , app:world_cuisines )
begin with "world cuisines" VIEW Settings	( OPEN , component:view_settings , app:world_cuisines )
visit yes	( PRESS , yes )
two-tap cooking	( DOUBLE_PRESS , cooking )
click Stop	( PRESS , stop )
introduce global cuisines	( OPEN , app:world_cuisines )
enable VIEW Main on the quick notepad.	( OPEN , component:view_main , app:fast_notepad )
begin quickly notepad	( OPEN , app:fast_notepad )
view more information about world cuisines	( OPEN , component:view_detail , app:world_cuisines )
VIEW FAVORITE CUISINES FROM AROUND THE WORLD	( OPEN , component:view_favorites , app:world_cuisines )
select Stop	( PRESS , stop )
pick my recipe	( PRESS , my_recipe )
get going	( PRESS , start )
I want to access the settings of world cuisines.	( OPEN , component:view_settings , app:world_cuisines )
adjust text size	( PRESS , text_size )
mark the cooking box.	( PRESS , cooking )
open WORLD COOKING VIEW FAVORITES	( OPEN , component:view_favorites , app:world_cuisines )
I want to debut VIEW Splash on international cuisines.	( OPEN , component:view_splash , app:world_cuisines )
access the world cuisines video preview	( OPEN , component:view_video_preview , app:world_cuisines )
view comments about world cuisines, please	( OPEN , component:view_comments , app:world_cuisines )
visit VIEW Purchase on world foods	( OPEN , component:view_purchase , app:world_cuisines )
launch VIEW Shoppinglist for world foods	( OPEN , component:view_shoppinglist , app:world_cuisines )
begin editing on a quick notepad	( OPEN , component:edit , app:fast_notepad )
use VIEW Main on a fast notepad.	( OPEN , component:view_main , app:fast_notepad )
tick off the settings	( PRESS , settings )
VIEW Grid on global cuisines, please	( OPEN , component:view_grid , app:world_cuisines )
I desire to activate Edit in quick notepad.	( OPEN , component:edit , app:fast_notepad )
open VIEW Language for world cuisines	( OPEN , component:view_language , app:world_cuisines )
move on to	( PRESS , next )
Double-click the burger	( DOUBLE_PRESS , healthy_burger )
I'd like to visit VIEW Favorites on world cuisines.	( OPEN , component:view_favorites , app:world_cuisines )
introduce the VIEW Video Grid for global cuisines	( OPEN , component:view_video_grid , app:world_cuisines )
visit ok	( PRESS , ok )
settings, pressing twice	( DOUBLE_PRESS , settings )
visit the VIEW Comments on cuisines page	( OPEN , component:view_comments , app:world_cuisines )
launch VIEW Bookmarked Videos on global cuisines	( OPEN , component:view_videos_bookmarked , app:world_cuisines )
show me VIEW Home on cuisines	( OPEN , component:view_home , app:world_cuisines )
choose "yes"	( PRESS , yes )
begin VIEW Main on a quick notepad.	( OPEN , component:view_main , app:fast_notepad )
show me VIEW Main on the unit converter.	( OPEN , component:view_main , app:unit_converter_ultimate )
view Splash on world cuisines for me	( OPEN , component:view_splash , app:world_cuisines )
double-tap settings	( DOUBLE_PRESS , settings )
hit Stop	( PRESS , stop )
Double-tap "Go!"	( DOUBLE_PRESS , let's_go )
browse settings	( PRESS , settings )
open VIEW world cuisines internal Generic Firebase Idp	( OPEN , component:view_firebase_auth_internal_generic_idp , app:world_cuisines )
pick healthy burgers	( PRESS , healthy_burger )
Double-clicking cooking	( DOUBLE_PRESS , cooking )
go to VIEW Videos Bookmarked on world cuisines	( OPEN , component:view_videos_bookmarked , app:world_cuisines )
access settings	( PRESS , settings )
Okay, double-tap	( DOUBLE_PRESS , ok )
activate my account	( PRESS , my_account )
next	( PRESS , next )
next, press twice	( DOUBLE_PRESS , next )
OPEN VIEW Recipe Store for world dishes	( OPEN , component:view_recipe_store , app:world_cuisines )
text size, please	( PRESS , text_size )
view Purchase on cuisines	( OPEN , component:view_purchase , app:world_cuisines )
view information about World Cuisines	( OPEN , component:view_detail , app:world_cuisines )
Select "Stop"	( PRESS , stop )
I want to access the world cuisines firebase internal Recaptcha page.	( OPEN , component:view_firebase_auth_internal_recaptcha , app:world_cuisines )
choose Let's go.	( PRESS , let's_go )
tick off my account.	( PRESS , my_account )
fast notebook, please	( OPEN , app:fast_notepad )
starting with world cuisines, VIEW FAVORITE DETAIL	( OPEN , component:view_favorite_detail , app:world_cuisines )
visit the steak timer's VIEW gms tagmanager Tag Manager Preview page.	( OPEN , component:view_gms_tagmanager_tag_manager_preview , app:steak_timer )
To start, click twice.	( DOUBLE_PRESS , start )
visit world cuisines	( OPEN , app:world_cuisines )
twice click "ok"	( DOUBLE_PRESS , ok )
launch the VIEW Grid for cuisines	( OPEN , component:view_grid , app:world_cuisines )
show me VIEW Recipe Store for cuisines 	( OPEN , component:view_recipe_store , app:world_cuisines )
cross off "start"	( PRESS , start )
visit steaktimer	( OPEN , app:steak_timer )
choose ok	( PRESS , ok )
quickly access notepad SEND Edit	( OPEN , component:send_edit , app:fast_notepad )
access to world cuisines’ VIEW Shoppinglist	( OPEN , component:view_shoppinglist , app:world_cuisines )
to the cooking	( PRESS , cooking )
begin VIEW HOME on international cuisines	( OPEN , component:view_home , app:world_cuisines )
double-click "yes"	( DOUBLE_PRESS , yes )
VIEW Video Search for world cuisines	( OPEN , component:view_video_search , app:world_cuisines )
click "start"	( PRESS , start )
world cuisines	( OPEN , app:world_cuisines )
select "ok"	( PRESS , ok )
choose "start"	( PRESS , start )
enable VIEW User Profile for WORLD Cuisines	( OPEN , component:view_user_profile , app:world_cuisines )
quickly start a notepad	( OPEN , app:fast_notepad )
click here for an overview of world cuisines	( OPEN , component:view_introduction , app:world_cuisines )
I want to access VIEW Search for international cuisines.	( OPEN , component:view_search , app:world_cuisines )
then tick next	( PRESS , next )
Double-click "Go!"	( DOUBLE_PRESS , let's_go )
Tap my account twice	( DOUBLE_PRESS , my_account )
tick off "yes"	( PRESS , yes )
by selecting VIEW Favorite Detail under international cuisines	( OPEN , component:view_favorite_detail , app:world_cuisines )
VIEW Favorites on world cuisines	( OPEN , component:view_favorites , app:world_cuisines )
tick off "ok"	( PRESS , ok )
visit the VIEW Video Grid page for world cuisines	( OPEN , component:view_video_grid , app:world_cuisines )
view the steak timer's eggtimer main page.	( OPEN , component:view_eggtimer_main , app:steak_timer )
healthy burger	( PRESS , healthy_burger )
to the top, scroll	( SWIPE , UP )
to the right	( SWIPE , RIGHT )
extended tap cooking	( LONG_PRESS , cooking )
toggle on VIEW Language for world cuisines	( OPEN , component:view_language , app:world_cuisines )
select next.	( PRESS , next )
VIEW User Profile on world cuisines	( OPEN , component:view_user_profile , app:world_cuisines )
I wish to access my favourite information about global cuisines.	( OPEN , component:view_favorite_detail , app:world_cuisines )
Press "my account" twice	( DOUBLE_PRESS , my_account )
select "start"	( PRESS , start )
turn on VIEW Main on the ultimate unit converter	( OPEN , component:view_main , app:unit_converter_ultimate )
visit VIEW Video Search under world cuisines.	( OPEN , component:view_video_search , app:world_cuisines )
switch on the cooking	( PRESS , cooking )
open Edit on quick notepad	( OPEN , component:edit , app:fast_notepad )
Next selection	( PRESS , next )
Go to VIEW Main in quick notebook.	( OPEN , component:view_main , app:fast_notepad )
access VIEW Main on the unit converter ultimate	( OPEN , component:view_main , app:unit_converter_ultimate )
long-tap setting	( LONG_PRESS , settings )
switch to Stop	( PRESS , stop )
switch on ok	( PRESS , ok )
Press Let's go twice.	( DOUBLE_PRESS , let's_go )
see Splash on international cuisines	( OPEN , component:view_splash , app:world_cuisines )
visit Stop	( PRESS , stop )
VIEW Settings for global cuisines	( OPEN , component:view_settings , app:world_cuisines )
toggle on VIEW Purchase for world cuisines	( OPEN , component:view_purchase , app:world_cuisines )
visit VIEW Video Preview on world cuisines	( OPEN , component:view_video_preview , app:world_cuisines )
begin with "global cuisines" VIEW Splash	( OPEN , component:view_splash , app:world_cuisines )
visit Let's Go	( PRESS , let's_go )
access to WORLD Cuisines VIEW Language	( OPEN , component:view_language , app:world_cuisines )
long-press "my account"	( LONG_PRESS , my_account )
to the right	( SWIPE , RIGHT )
to the left	( SWIPE , LEFT )
to the bottom	( SWIPE , DOWN )
to the top	( SWIPE , UP )
up	( SWIPE , UP )	['<pad>']
up to the top	( SWIPE , UP )	['<pad>']
to top	( SWIPE , UP )	['<pad>']
down	( SWIPE , DOWN )	['<pad>']
to bottom	( SWIPE , DOWN )	['<pad>']
down to the bottom	( SWIPE , DOWN )	['<pad>']
down and to the bottom	( SWIPE , DOWN )	['<pad>']
up	( SWIPE , UP )	['<pad>']
coming up	( SWIPE , UP )	['<pad>']
going up to the top	( SWIPE , UP )	['<pad>']
page down	( SWIPE , DOWN )	['<pad>']
down over to the bottom	( SWIPE , DOWN )	['<pad>']
left	( SWIPE , LEFT )	['<pad>']
to left	( SWIPE , LEFT )	['<pad>']
right	( SWIPE , RIGHT )	['<pad>']
to right	( SWIPE , RIGHT )	['<pad>']